BBBBBBBBBBBBBBBBBBBBBBBBBBBBBBBBBBBBBBBBBBBBBBBBBBBBBBB








              BBB  BBBBBBBBBBBBBBBBBBBBBBBBBBBBBBBBBBBBB
            BBBBB  BBBBBBBBBBBBBBBBBBBBBBBBBBBBBBBBBBBBB
          BBBBBBB  BBBBBBBBBBBBBBBBBBBBBBBBBBBBBBBBBBBBB
        BBBBBBBBB  BBBBBBBBBBBBBBBBBBBBBBBBBBBBBBBBBBBBB
      BBBBBBBBBBB  BBBBBBBBBBBBBBBBBBBBBBBBBBBBBBBBBBBBB
    BBBBBBBBBBBBB        BBBBBBBBBBBBBBBBBBBBBBBBBBBBBBB
  BBBBBBBBBBBBBBBBBBBBBBBBBBBBBBBBBBBBBBBBBBBBBBBBBBBBBB
BBBBBBBBBBBBBBBBBBBBBBBBBBBBBBBBBBBBBBBBBBBBBBBBBBBBBBBB